111111111111
100C01100C01
101E00100C01
100111000C01
100000100C01
100C000P0C01
101001100C01
111111111111

